
विकिपीडियायां देवनागरीलिप्या उट्टङ्कनार्थं बहवः उपायाः  विद्यन्ते । एतेषु कस्यचित् उपायस्य प्रयोगं कर्तुम् अर्हति अथवा विकिपीडियायाम् अन्तर्भूतायाः व्यवस्थायाः उपयोगं कर्तुम् अर्हति ।
संस्कृत विकिपीडिया इति स्थले सम्पादनार्थे अन्तर्निर्मितं सम्पादकोपकरणमपि उपलभ्यते। इदं ध्वन्यात्मक-लिप्यन्तरणमाधारितं अस्ति। तस्य प्रयोगार्थे देवनागरी- लिप्यां 'क' इत्यक्षरं लिखितुं 'ka' टंकणं करोतु। एतस्याः तालिकायाः सहयोगेन देवनागर्या लेखितुं शक्यते -
वर्गीयव्यञ्जनानि
अवर्गीयव्यञ्जनानि
क	= ka का	= kaa कि	= ki की	= kI कु	= ku कू	= kU कृ	= kR कॄ	= kRR कॢ	= kLl कॣ	= kLll कॅ    = ke^ कॆ	= ke के	= kE कै	= kai कॉ	= ko^ कॊ	= ko को	= kO कौ    = kau कं    = kaM कः   = kaH 
क्क = kka
ङ्क = ngka
ङ्ङ = ngnga
च्च = chcha
ञ्च = njcha
ञ्ञ = njnja
ट्ट = TTa
ण्ट = NTa
ण्ण = NNa
त्त = tta
न्त = nta
न्न = nna
प्प = ppa
म्प = mpa
म्म = mma

ख्य = khya
ग्ध = gdha
द्य = dya
क्र = kra
त्र = tra 
द्ध = ddha
र्क = rka
न्द = nda
न्द्र = ndra
ग्द्ध = gddha
ज्ञ = jnj
अन्तर्वर्तिना लिपिपरिवर्तकोपकरणेन देवनागरीटङ्कनसमये आङ्ग्ललिपिना सङ्ख्याङ्कः याथातथ्यम् इष्यते चेत्, आदौ \ इति चिह्नं टङ्कितव्यं, ततः सङ्ख्याङ्कः टङ्कितव्यः। यथा हि, \1 इति टङ्कनेन 1 इत्यागमिष्यति। 
InScript is the standard keyboard for Indian scripts. The image shows Devanagri inscript. 
