अब्खाजिया - अफगानस्थान - अल्बानिया - अल्जीरिया - अंडोरा - अंगोला - अंटीग्वा - अर्जन्टीना - अजर्बैजान
आर्मीनिया - आस्ट्रिया - आस्ट्रेलिया - आयर्लैंड - आइसलैंड 
इन्दोनेशिया - इस्रैल - इटली
ईराक - ईरान - ईजिप्ट- ईथ्योपिया
उरुग्वाय - उजबेकिस्थान
एक्वाडोर - एल-साल्वाडोर - एस्टोनिया - एरिट्रिया"Хирология - наука о руке"евкееееее
कोट ऐवरी 
ओमान
कम्बोदिया - केनडा - केमेरून - केप वर्डी - कोलोम्बिया - कोमोरोस - कौंगो - कोस्टा रीका - क्रोएशिया - क्यूबा - केन्द्रीय अफ्रीका गणराज्य - कजाकस्थान - किरिबाटी - किरगिस्थान - कतार - केन्या - कोरिया - कुवैत
ख
ग्रीस - गाबोन - गाम्बिया - ग्रेनाडा - ग्वाटेमाला - गिनी - गिनी-बिसो - गयाना
घाना 
चाड - चिले - चीन - चेक रिपब्लिक
जार्जिया - जर्मनी - जिबूटी - जमैका - जापान - जार्डन - जाम्बिया - जिम्बाबवे
टोगो - टोंगा - ट्रिनिडाड - टंजानिया- टिमोर - टुनिशिया - टुवालु
डेनमार्क - डोमोनिका - डोमोनिकन रिपब्लिक
तुर्किये - तैवान - ताजिकिस्थान - तुर्कमिनिस्थान
थाइलैंड
दक्षिण कोरिया
नमीबिया - नौरु - नेपाल - नेदरलैंड्स - न्यू-जीलैंड - निकारगुवा - नीजे - नैजीरिया - नार्वे
पाकिस्तान - पलाऊ - पानामा - पपुवा न्यू गिनी - पेरेग्वाय - पोलैंड - पेरु - पुर्तगाल
फिजी - फिन्लैंड - फ्रांस - फिलिपीन्स - फिलिस्तीन
बहामास - बहरैन - बंगलादेश - बार्बाडोस - बेलारूस - बेलीज - बेनिन - बेल्जियम - बोलिविया - बास्निया - बोत्सवाना - ब्रासील - ब्रूनै - बुल्गारिया - बुर्कीना-फासो - बुरुंडी - बर्मा अद्य म्‍यन्मार - ब्रिटेन
भारत - भूटान
मडगास्कर - मलावी - मलयेशिया - मालदीव - माली - माल्टा - मारिटेनिया - मारिशस - - मेसेडोनिया - मार्शल द्वीप - मेक्सिको - मैक्रोनीशिया - मोल्दोवा - मोनाको - मंगोलिया - मोराको - मोजम्बीक - मयन्मार
यमन 
रोमानिया - रूस - रवाण्डा
लाओस - लाट्विया - लेबनान - लेसोथो - लायबीरिया - लिबिया - लिक्टनस्टैन - लिथ्वानिया - लक्सम्बर्ग
वनुवाटु - वेनेज्वेला - वैटिकन - वियेतनाम
श्रीलङ्का
सायप्रस - सेंट किट् - सेंट लूसिया - सेंट विन्सेंट - समोआ - सान मरीनो - सऊदी अरब - सर्बिया - सेनेगल - सेशेल - सियारा-लियोन - सिंगापोर - सोलोमन-द्वीप - स्लोवाकिया - स्लोवीनिया - सोमालिया - सोमालिलैंड - साउथ-अफ्रीका दक्षिण-अफ्रीका - स्पेन - सूडान - स्वाजीलैंड - स्विटजरलैंड - सिरिया - सुरिनाम - स्वीडन - संयुक्त राज्य अमेरिका
हेटी - हांडूरस - हंगरी
